00000000000000000000
01111111111111111110
00000200000333000044
00000200000030000044
00000200000030000444
00000200000030004444
00000200000030044444
00000200000030444444
00000200000030000000
01111211111331111110
00000200000030000000
00000200000030000000
00000200000030000000
00000200000030000000
01111211111331111110
00000000000000000000
